111111111111
10P00C0C0C01
100001001001
1C0001000C01
10000C000E01
111111111111

